11111111111111111111111111111111111111111111111111111111111111111111111111111111111111111111111111111111111111111111111
10000000000000000000100000000000001C10000000000000000000000000000000000000000000000000000000000000000000000000000000001
10000000000P00000000000000000000001010000000000000000000000000000000000000000000000000000000000000000000000000000000001
10000000000000000000000000000000000000000000000000000000000000000000000000000000000000000000000000000000000000000000001
11000000000000000000000000000000000000000000000000000000000000000000000000000000000000000000000000000000000000000000001
10000000000000000000000000000000000000000000000110101000000000000001100000000000000000000000000000000000000000000000001
10000000000000000000000C00000000000000000000000000000000000000000000000000000000000000000000000000000000000000000000001
1000000000000000000000CEC0000000000000000000000000000000000000000000000000000000000000000000000000000000000000000000001
11000000000000000000000C00000000000000010000000000000000000000000000000000000000000000000000000000000000000000000000001
11111111111111111111111111111111111111111111111111111111111111111111111111111111111111111111111111111111111111111111111