111111111111111111111111111111111111111111111111111111111111111111111111111111111111111111
1000011000000000111100000000000000000011000000000000000000110000000000010000001000000001C1
10P000000000000000000000000000000000000000000000000000000000000000000000000000000000001101
100000000000000000000000000000000000000000000000000000000000000000000000000000000000000101
100000000000000000000000000000000000000000000000000000000000000000000000000000000000000101
100001110000110000000000000000000000000000000000000000000000000000000000000000000000000101
100000000000000000000000000000000000000000000000000000000000000000000000000000000000000101
100000000000000000000000000000000000000000000000000000000000000000000000000000000000011101
10000000000000000000000000000000000GG00000000000000000000000000000000000000000000000010001
10000000000000000001000000001000000GG00000000000000000000000000000000000000000000000010001
100000000000000000000000000000000000000000000000000000000000SS0000000000000000000000010011
1000000000000000000000000C0000000000000000000000000000000000000000000000000000000000010G01
1001000000000000000000000000000000000000000000000000000CC000000000000000000000000000000001
1000000000000000000000000000000000000000000000000000000000000000000000000000C0000000000001
100010000000000000000000000000000000000000000000000000000000000000000000000000000000000011
10000000000C0000000000000000000000000000GG000000000000000000000000000000000000000000000001
110000000000000000000000000000000000000000000000000000000000000000000000000000000000000001
1000000000000000000000000000000000000000000G0000000000000000000000000000000000000000000001
1000000GG00000000000000000000000000000000000000000000000000000000000CC00000000000000000001
100000000000000000000000000000000000000000000000000000000000000000000000000000000000000101
1100000CC000000000000000000GG0000000000000000000000000011000000000000000000000000000000001
100000000000000000000100000GG0000000000000000000000000000000000000000000000000000000000001
1000000000000000000000000000000000000000000000000000000000000000000000000000C0000000000011
11000000000000000000000000000000000000000000001110000000000000000000000000CCCC000000000001
1000000S00000000000000000000110000000000000000000000000000000000000000000000C0000000000001
100000000000000000000000000000000000000000000000000000000000000000000000000000000000001001
100000000000000000000000000000000000000000000000000000000000000000000000000000000000000001
10000S0000000000000000000000000000000000000000000000000000000000000S0000000000000000000001
110000000000000000000000000000000000000000000000000000000000000000000000000000000000000011
100000000C00000000000000000000000000000000000000000000000000000000000000000000000000000001
10000000CC000000000000000000000000000000000000000000000000000E0000000000000000000000100001
110000000000000000000000000000000000000000000000000000000000000000000000000000000000000001
1000000000000G0000000000000000000000000000000000000000000000000000000000000000000000001001
1000000000000000SS000000000000000000000000000000000000000000000000000000000000000000000111
1000CC00000000000000000000000000000000000000000SS00000000000000000000000000000000000000001
11000000000000000000000000000000000000000000000SS0000000000000000000000000C000000000000001
10GG000CC000000000000000000000000000000000000000000000000000000000000000000000000000000011
101000000000000000000000000000000000000000000000000000000000000000000000000000000000000001
10001100C000000000000000001100000000001100000000000000000000000110000000000000000000010001
111111111111111111111111111111111111111111111111111111111111111111111111111111111111111111