111111111
100000001
1000C0001
100000001
100000001
1000000E1
110011011
110011011
100000001
1P0000001
111111111