1111111111111111111
1P00000000000000001
10111F1110111F11101
1011111110111111101
10G1111100011111G01
10G1111110111111G01
1011111110111111101
10110111S0S11101101
100000000C000000001
10110111S0S11101101
1011111110111111101
10G1111110111111G01
10G1111100011111G01
1011111110111111101
10111F1110111F11101
10000000000000000E1
1111111111111111111