111111
1C0001
101001
10E001
1000P1
111111