111111
10C001
100001
10E001
110P01
111111