111111
1C1001
100001
10E001
1010P1
111111