111111
1C0001
1GEP01
101111
1G1111
111111