111111
1C0001
100011
11E001
1000P1
111111