1111111
1C01001
1000001
1001011
11E0001
1001P01
1111111