1111111111111
1C010000001C1
1000011110011
1P0011E000001
1111111111111