11111111111111
1001C000001111
1F00P0000G0001
10000000001001
11010110001F01
10000000001111
100C0000000001
110000000CS001
1000G000001111
1100E000001111
11111111111111